R 640 1080
NO textures/wall_n.xpm
SO textures/wall_s.xpm
WE textures/wall_w.xpm
EA textures/wall_e.xpm
S textures/sp_2.xpm
F 110,153,15
C 255,255,255

11111111    11111111
10000001    11111111
1000E201    11111111
10000001
10000001
10000001
10000001
10000001
10000001
10000001
10000001
10000001
11111111
