R 640 1080
NO textures/wall_n.xpm
SO textures/wall_s.xpm
WE textures/wall_w.xpm
EA textures/wall_e.xpm
S textures/sp_2.xpm
F 220,100,0
C 255,255,255

11111111
100E0001
11111111
